1,1,1,1,1,1,1,1,1,1,1,1,1,1,1,1,1,1,1,1,1,1,1,1,1,1,1,1,1,1
1,,,1,1,,,,,,,,,,,,,,,,,,,,,,,,,1
1,2,,1,1,,,,1,1,1,1,1,1,1,1,1,1,1,1,1,1,1,1,1,1,1,,,1
1,1,,1,1,,,,1,,,,,,,,,,,,,,,,,,,,,1
1,1,,1,1,,,,1,,,4,,,,,,,,,,,,,,,,,,1
1,1,,1,1,,,,1,,,1,1,1,1,1,1,1,1,1,1,1,1,1,1,1,1,1,1,1
1,1,,1,1,,,,1,,,,,,,,,,,,,,,,,,,,,1
1,1,,1,1,,,,1,,,,,,,,,,,,,,,,,,,,,1
1,1,,1,1,,,,1,,,,,,,,,,,,,,,,,,,,,1
1,1,,1,1,,,,1,,,,,,,,,,,,,,,,,,,,,1
1,1,,1,1,,,,1,1,1,1,1,1,1,1,1,1,1,1,1,,,,,,,,,1
1,1,,1,1,,,,1,,,,,,,,,,,,,,,,,,,,,1
1,1,,1,1,,,,1,,,,,,,,,,,,,,,,,,,,,1
1,1,,1,1,,15,,1,,,,,,,,,,,,,,,,,,,,,1
1,1,,1,1,,,,1,,,,,,,,,,,,,,,,,,,,,1
1,1,,,4,,,,1,,,,,,,,,,,,,,,,,,,,,1
1,1,1,1,1,1,1,1,1,1,1,1,1,1,1,1,1,1,1,1,1,1,1,1,1,1,1,1,1,1
